AG=Aguascalientes
BJ=Baja California
BS=Baja California Sur
CP=Campeche
CH=Chiapas
CI=Chihuahua
CU=Coahuila de Zaragoza
CL=Colima
DF=Distrito Federal
DG=Durango
EM=Estado Mexico
GJ=Guanajuato
GR=Guerrero
HG=Hidalgo
JA=Jalisco
MX=Mexico
MH=Michoacan
MR=Morelos
NA=Nayarit
NL=Nuevo Leon
OA=Oaxaca
PU=Puebla
QA=Queretaro
QR=Quintana Roo
SL=San Luis Potosi
SI=Sinaloa
SO=Sonora
TA=Tabasco
TM=Tamaulipas
TL=Tlaxcala
VL=Veracruz Llave
YC=Yucatan
ZT=Zacatecas